S..#..C..T
#T##..###.
#.###E###E
#.E.C.###.
###T#####G